01,01,01,02,02,02,00,00,00,00,00,00,00,00,00,00,00,00,00,00,00,00,00,00,00
01,01,01,02,02,02,02,00,00,00,00,00,00,00,00,00,00,00,00,00,00,00,00,00,00
01,01,01,02,02,02,00,00,00,00,00,00,00,00,00,00,00,00,00,00,00,00,00,00,00
01,01,02,02,02,02,00,00,00,00,00,00,00,00,00,00,00,00,00,00,00,00,00,00,00
02,02,01,02,01,02,00,00,00,00,00,00,00,00,00,00,00,00,00,00,00,00,00,00,00
02,02,02,02,02,02,00,00,00,00,00,00,00,00,00,00,00,00,00,00,00,00,00,00,00
02,02,01,02,01,01,02,00,00,00,00,00,00,00,00,00,00,00,00,00,00,00,00,00,00
02,04,02,02,02,02,02,00,00,00,00,00,00,00,00,00,00,00,00,00,00,00,00,00,00
04,04,02,02,02,02,01,02,02,00,00,00,00,00,00,00,00,00,00,00,00,00,00,00,00
04,04,02,02,01,01,01,01,01,02,02,00,00,00,00,00,00,00,00,00,00,00,00,00,00
04,04,04,01,02,01,01,01,02,00,02,00,02,00,00,00,00,00,00,00,00,00,00,00,00
04,04,04,01,02,02,03,02,02,02,02,02,02,02,00,00,00,00,00,00,00,00,00,00,00
04,04,04,01,02,02,03,03,03,03,03,03,03,02,00,00,00,00,00,00,00,00,00,00,00
04,04,04,01,03,02,02,02,02,03,02,02,02,00,00,00,00,00,00,00,00,00,00,00,00
04,03,04,03,04,03,03,03,02,02,00,00,00,00,00,00,00,00,00,00,00,00,00,00,00
00,04,04,04,04,03,03,03,00,00,00,00,00,00,00,00,00,00,00,00,00,00,00,00,00
00,04,04,03,03,03,03,03,00,00,00,00,00,00,00,00,00,00,00,00,00,00,00,00,00
00,00,00,00,00,03,03,03,00,00,00,00,00,00,00,00,00,00,00,00,00,00,00,00,00
00,00,00,00,00,00,00,00,00,00,00,00,00,00,00,00,00,00,00,00,00,00,00,00,00
00,00,00,00,00,00,00,00,00,00,00,00,00,00,00,00,00,00,00,00,00,00,00,00,00
